00100000
00110000
00011110
00010000
00111000
00001000
11111110
00000000